NO ./textures/north.xpm
SO ./textures/south.xpm
WE ./textures/west.xpm
EA ./textures/east.xpm
F 220,100,0
C 225,30,0

1111111111111111111111
1000000000110000000001
1011000001110000000001
1001000000000000000001
1111111110110000011101
1000000000110000011101
1000000000000000000001
1000000000000000000001
1000000000000000000001
1111111111111111111111
