NO ./textures/wall_1.xpm
SO ./textures/wall_2.xpm
WE ./textures/wall_3.xpm
EA ./textures/wall_4.xpm
F 40,40,40
C 0,0,0

1111111111111111111111
1000000000110000000001
1011000001110000000001
1001000000000000000001
1111111110110000011101
1000000000110000011101
1000000000000000000011
1000000000000000000001
1000000000000000E00001
1111111111111111111111
